{
  "player_start": {
    "x": 100, 
    "y": 300
  },
  "rooms": {
    "start": {
      "layers": {
        "background": [
          [1, 1, 1, 1, 1, 1, 1, 1, 1, 1, 1, 1, 1, 1, 1],
          [1, 0, 0, 0, 0, 0, 0, 0, 0, 0, 0, 0, 0, 0, 1],
          [1, 0, 0, 0, 0, 0, 0, 0, 0, 0, 0, 0, 0, 0, 1],
          [1, 0, 0, 0, 0, 0, 0, 0, 0, 0, 0, 0, 0, 0, 1],
          [1, 0, 0, 0, 0, 0, 0, 0, 0, 0, 0, 0, 0, 0, 1],
          [1, 0, 0, 0, 0, 0, 0, 0, 0, 0, 0, 0, 0, 0, 1],
          [1, 0, 0, 0, 0, 0, 0, 0, 0, 0, 0, 0, 0, 0, 1],
          [1, 0, 0, 0, 0, 0, 0, 0, 0, 0, 0, 0, 0, 0, 1],
          [1, 0, 0, 0, 0, 0, 0, 0, 0, 0, 0, 0, 0, 0, 1],
          [1, 1, 1, 1, 1, 1, 1, 1, 1, 1, 1, 1, 1, 1, 1]
        ],
        "foreground": [
          [2, 2, 2, 2, 2, 2, 2, 2, 2, 2, 2, 2, 2, 2, 2],
          [2, 0, 0, 0, 0, 0, 0, 0, 0, 0, 0, 0, 0, 0, 2],
          [2, 0, 0, 0, 0, 0, 0, 0, 0, 0, 0, 0, 0, 0, 2],
          [2, 0, 0, 0, 0, 0, 0, 0, 0, 0, 0, 0, 0, 0, 2],
          [2, 0, 0, 0, 0, 0, 0, 0, 0, 0, 0, 0, 0, 0, 2],
          [2, 0, 0, 0, 0, 0, 0, 0, 0, 0, 0, 0, 0, 0, 2],
          [2, 0, 0, 0, 0, 0, 0, 0, 0, 0, 0, 0, 0, 0, 2],
          [2, 0, 0, 0, 3, 3, 3, 3, 3, 0, 0, 0, 0, 0, 2],
          [2, 0, 0, 0, 0, 0, 0, 0, 0, 0, 0, 0, 0, 0, 2],
          [2, 2, 2, 2, 2, 2, 2, 2, 2, 2, 2, 2, 2, 2, 2]
        ]
      },
      "tile_mapping": {
        "0": "empty",
        "1": "background_wall",
        "2": "wall",
        "3": "platform"
      },
      "memory_orbs": [
        {"x": 300, "y": 400, "memory_type": "red"},
        {"x": 500, "y": 300, "memory_type": "blue", "duration": 15000}
      ],
      "doors": [
        {"x": 800, "y": 448, "width": 64, "height": 128, "required_memory": "red", "target_room": "puzzle1", "target_x": 100, "target_y": 300}
      ],
      "levers": [
        {"x": 600, "y": 536, "target_id": "platform1", "action": "toggle"}
      ],
      "moving_platforms": [
        {"x": 300, "y": 350, "width": 128, "height": 32, "move_x": 0, "move_y": -100, "speed": 0.01, "id": "platform1"}
      ]
    },
    "puzzle1": {
      "layers": {
        "background": [
          [1, 1, 1, 1, 1, 1, 1, 1, 1, 1, 1, 1, 1, 1, 1],
          [1, 0, 0, 0, 0, 0, 0, 0, 0, 0, 0, 0, 0, 0, 1],
          [1, 0, 0, 0, 0, 0, 0, 0, 0, 0, 0, 0, 0, 0, 1],
          [1, 0, 0, 0, 0, 0, 0, 0, 0, 0, 0, 0, 0, 0, 1],
          [1, 0, 0, 0, 0, 0, 0, 0, 0, 0, 0, 0, 0, 0, 1],
          [1, 0, 0, 0, 0, 0, 0, 0, 0, 0, 0, 0, 0, 0, 1],
          [1, 0, 0, 0, 0, 0, 0, 0, 0, 0, 0, 0, 0, 0, 1],
          [1, 0, 0, 0, 0, 0, 0, 0, 0, 0, 0, 0, 0, 0, 1],
          [1, 0, 0, 0, 0, 0, 0, 0, 0, 0, 0, 0, 0, 0, 1],
          [1, 1, 1, 1, 1, 1, 1, 1, 1, 1, 1, 1, 1, 1, 1]
        ],
        "foreground": [
          [2, 2, 2, 2, 2, 2, 2, 2, 2, 2, 2, 2, 2, 2, 2],
          [2, 0, 0, 0, 0, 0, 0, 0, 0, 0, 0, 0, 0, 0, 2],
          [2, 0, 0, 0, 0, 0, 0, 0, 0, 0, 0, 0, 0, 0, 2],
          [2, 0, 0, 0, 0, 0, 0, 0, 0, 0, 0, 0, 0, 0, 2],
          [2, 0, 0, 0, 0, 0, 0, 0, 0, 0, 0, 0, 0, 0, 2],
          [2, 0, 0, 0, 0, 0, 0, 0, 0, 0, 0, 0, 0, 0, 2],
          [2, 0, 3, 3, 0, 0, 0, 0, 0, 0, 3, 3, 0, 0, 2],
          [2, 0, 0, 0, 0, 0, 3, 3, 0, 0, 0, 0, 0, 0, 2],
          [2, 0, 0, 0, 0, 0, 0, 0, 0, 0, 0, 0, 0, 0, 2],
          [2, 2, 2, 2, 2, 2, 2, 2, 2, 2, 2, 2, 2, 2, 2]
        ]
      },
      "tile_mapping": {
        "0": "empty",
        "1": "background_wall",
        "2": "wall",
        "3": "platform"
      },
      "memory_orbs": [
        {"x": 300, "y": 500, "memory_type": "green"},
        {"x": 700, "y": 500, "memory_type": "purple", "duration": 10000}
      ],
      "doors": [
        {"x": 100, "y": 448, "width": 64, "height": 128, "required_memory": null, "target_room": "start", "target_x": 750, "target_y": 300},
        {"x": 800, "y": 448, "width": 64, "height": 128, "required_memory": "blue", "target_room": "puzzle2", "target_x": 100, "target_y": 300}
      ],
      "switches": [
        {"x": 300, "y": 536, "required_memory": "green", "target_id": "platform2", "action": "activate"}
      ],
      "moving_platforms": [
        {"x": 500, "y": 550, "width": 128, "height": 32, "move_x": 100, "move_y": 0, "speed": 0.005, "id": "platform2"}
      ]
    }
  }
}